acronym	name
NIRS	Non-invasive Respiratory Support Ontology
ONTOPSYCARE	Ontology developed during PsyCARE project
IVAN	IVAN OTERO
BERVO	The Biological and Environmental Research Variable Ontology
STY1	STY1
SHOREBREAK02	shorebreak02
SHOREBREAK01	shorebreak01
MWO	NFDI MatWerk Ontology
PHASES	Promoting Health Aging through Semantic Enrichment of Solitude Research
ODFA	Ontology of Dental Care-Related Fear and Anxiety
BCIO	Behaviour Change Intervention Ontology
LTER-CV	LTER Controlled Vocabulary
COGITO	Cognitive Task Ontology
BBO	Biomedical Burden Ontology
VALUESETS	valuesets
OC_E	OntoCaimer_Examples
O3	Operational Ontology for Oncology 
NAMO	New Approach Methodology Ontology
ONTONEPHRO	Nephrology Ontology in order to index MOOC
ROADMAP	Radiology Ontology of AI Models, Datasets and Projects
SL_DIS	Sleep Disorders 
OCS	A Foundational Ontology for Computational Sociology
JFO	Japanese Food Ontology
SCO-U	Sustainability Core Ontology - Segment U
GENEVIEVE	Charlotte
GDCO	Data Collection Ontology
FOAF	Friend of a Friend Vocabulary
OLATDV	Medaka Developmental Stages
TM-OTHER-FACTORS	Traditional Medicine Other Factors Value Set
RDAO	Rare Diseases Awareness Ontology
HFO	Heart Failure Ontology
GFVO	Genomic Feature and Variation Ontology
G4-DSIP	Group 4-Data Science in Practice
FISHO	Fish Ontology
SIMON	Simple Measurement Ontology
ADW	Animal Natural History and Life History Ontology
INJURYTYPES	Injury Types
CST	Cancer Staging Terms
CSTD	Clinical smell and taste disorders
COLAO	Coleoptera Anatomy Ontology
GALLONT	Plant Gall Ontology
VIMM	In Vitro Methodologies Ontology for MAATrica metric
ONTOPBM	Ontology for Process-Based Modeling of Dynamical Systems (OntoPBM)
MEDDRA	Medical Dictionary for Regulatory Activities Terminology (MedDRA)
OGSF	Ontology for Genetic Susceptibility Factor
VODANADISEASES	VODANADiseases
CNO	Computational Neuroscience Ontology
SLSO	Space Life Sciences Ontology
COSTART	Coding Symbols for a Thesaurus of Adverse Reaction Terms
ISO19115MI	ISO 19115 Metadata Information
BIM	Biomedical Image Ontology
MCBCC	Breast Tissue Cell Lines Ontology
HMIS033B	HMIS 033
RDA-ISSUANCE	RDA Mode of Issuance
TYPON	Microbial Typing Ontology
TEST-M4M20-PAV	test-m4m20-subjects-pav
NEUDIGS	Neuroscience Domain Insight Graph
NCRO	Non-coding RNA Ontology
OPDE	OPD-Ethiopia
OPDT	opd_test
NCOD	NCoD
LC-MEDIA	Library of Congress Media Types Scheme
RNPRIO	Research Network and Patient Registry Inventory Ontology
CTCAE	Common Terminology Criteria for Adverse Events
NND_ND	NND_Neuropathological_Diagnosis
ISO19115ID	ISO 19115 Identification Information
RDO	Reusable Biodiversity Ontology
TESTEX	test1
AHSO	Animal Health Surveillance Ontology
CLO	Cell Line Ontology
ADO	Alzheimer's Disease Ontology
IMOBO	Intelligent Medicine oriented Biobank Ontology
WIKIPATHWAYS	WikiPathways
SOPHARM	Suggested Ontology for Pharmacogenomics
PLANTSO	Plant Stress Ontology
RAO	Rheumatoid Arthritis ontology
COVIDCRFRAPID	WHO COVID-19 Rapid Version CRF semantic data model
OGROUP	Orthologous Group Ontology
COKPME	COKPME - COVID19 Ontology for analyzing the Karnataka Private Medical Establishments Data  
ECG	Electrocardiography Ontology
ODHT	Digital Health Technologies
ISO19115PR	ISO 19115 Codelists
PGXO	PGxO
TOP-MENELAS	Menelas Project Top-Level Ontology
TM-SIGNS-AND-SYMPTS	Traditional Medicine Signs and Symptoms Value Set
ICF	International Classification of Functioning, Disability and Health
VODANANIGERIA	VODANANIGERIA
PHARE	Pharmacogenomic Relationships Ontology
INFRARISK	InfraRisk Ontology
HRA	Human Reference Atlas
WC	Whole-cell modeling ontology
VVMM	In Vivo Methodologies Ontology for MAATrica metric
GAMUTS	Radiology Gamuts Ontology
SYMP	Symptom Ontology
OAE	Ontology of Adverse Events
ECOSIM	ecosim ontology
AURA	KB_Bio_101
FRMO	Fall Risk Management Ontology 
LABO	clinical LABoratory Ontology
MSO	Multiple sclerosis ontology
OMP	Ontology of Microbial Phenotypes
PLIO	Protein-ligand interaction ontology
FLYGLYCODB	FlyGlycoDB
LDBASE	LDbase
ADMIN	Nurse Administrator
NCBITAXON	National Center for Biotechnology Information (NCBI) Organismal Classification
ERO	Eagle-I Research Resource Ontology
CCTOO	Cancer Care: Treatment Outcome Ontology
AISM	Ontology for the Anatomy of the Insect SkeletoMuscular system
HIVHPVSTOM	HIVHPVStom
BIRNLEX	Biomedical Informatics Research Network Project Lexicon
RCD	Read Codes, Clinical Terms Version 3 (CTV3) 
FPLX	FamPlex
EPSO	Epilepsy and Seizure Ontology
EPIE	Epigenetic Entity
EPIP	Epigenetic Process
EPIO	EpilepsyOntology
LAND-SURFACE	Land Surface classifiers
PANDA	Probabilistic Knowledge Assembly Ontology
SWO	Software Ontology
PSDS	Plant Structure Development Stage
PSDO	Performance Summary Display Ontology
OA	Web Annotation Ontology
OF	OntoFood
OM	Ontology of units of Measure
NND_CH	NND_Clinical_history
DSIP	Pharmacy mock data
TMO	Translational Medicine Ontology
LCDGT	Library of Congress Demographic Group Terms
PGHDPROV	Context and Provenance Based Standardized Patient Generated Health Data Shared with an Electronic Health Record
SUGARBIND	SugarBind
OMV	Ontology Metadata Vocabulary
SSN	Semantic Sensor Network Ontology
DTO	Drug Target Ontology
CEPH	Cephalopod Ontology
APAOCUEMPLOY	APA Occupational and Employment cluster
GLYCO	Glycomics Ontology
TM-CONST	Traditional Medicine Constitution Value Set
PLANP	Planarian Phenotype Ontology
CDMONTO	Common Diabetes Medications Ontology
VANDF	Veterans Health Administration National Drug File
RGD	RRB Group D
XAO	Xenopus Anatomy Ontology
GBOL	GBOL
TP_REL_FAM	Relation familiales
NATPRO	Natural Products Ontology
ALLERGIDOC	Allergy Ontology
HAROREADO	Halocynthia roretzi Anatomy and Development Ontology
CMR-QA	Cardiovascular Magnetic Resonance Quality Assessment Ontology
NEOMARK3	Neomark Oral Cancer Ontology, version 3
NEOMARK4	Neomark Oral Cancer Ontology, version 4
PMD	Persian Medicine Diseases Ontology
PMDO	Parkinson and Movement Disorder Ontology
COMODI	COMODI
E-PPO	Enhanced Personal Profile Ontology
SOS	emergência
CHD	Congenital Heart Defects Ontology
BOSHI	boshra
IDG_GL	IDG gene list
CCF	Human Reference Atlas Common Coordinate Framework Ontology
GCO	Genome Component Ontology
ZONMW-GENERIC	ZonMw Generic Terms
TIME	OWL-Time
EXTRACT	EXTeRnAl Conditions Taxonomy (EXTRACT)
VODANA-MPA	VODANA-MIGRANTS-PRESS ARTICLES
HMADO	Human Microbiome Associated Disease Ontology 
TADS	Tick Gross Anatomy Ontology
ONTOKBCF	Ontological Knowledge Base Model for Cystic Fibrosis
ELECTRICA	Ontology for ELEctronic tool for Clinicians, Trainers and Researchers In Child Abuse
COVID19-IBO	Covid19 Impact on Banking Ontology
CIDO	Coronavirus Infectious Disease Ontology
RCTV2	Read Clinical Terminology Version 2
ICNP	International Classification for Nursing Practice
CHEMBIO	Systems Chemical Biology and Chemogenomics Ontology 
ZECO	Zebrafish Experimental Conditions Ontology
DHMO	RADx Data Hub Metadata Ontology
MEDEON	Medical Error Ontology
NPOKB	Neuron Phenotype Ontology
DSIP2324_DEMO	DSIP2324_Demonstration
CAROLIO	Caroli's Disease and Syndrome Ontology
VODANAMFLCODE	VODANAFACILITIESLIST
CISAVIADO	Ciona savignyi Anatomy and Development Ontology 
OPMI	Ontology of Precision Medicine and Investigation
CSO	Clinical Study Ontology
ASDF	testiiii1
ONTOSINASC	Ontology of Information System on Live Births
CIDOC-CRM	CIDOC Conceptual Reference Model
ROO	Radiation Oncology Ontology
STY	Semantic Types Ontology
COVID-19-ONT-PM	COVID-19OntologyInPatternMedicine
WB-PHENOTYPE	C. elegans Phenotype Vocabulary
PMR	Physical Medicine and Rehabilitation
NMDCO	NMDC Ontology
OGR	Ontology of Geographical Region
ISO19115EX	ISO 19115 Extent Information
COGPO	Cognitive Paradigm Ontology
ONTODM-KDD	Ontology of Data Mining Investigations
DSAV	Digital Specimen Accessibility Vocabulary
ESFO	Enzyme Structure Function Ontology
GECKO	Genomics Cohorts Knowledge Ontology
SBO	Systems Biology Ontology
SBOL	Synthetic Biology Open Language Visual Ontology
OHPI	Ontology of Host-Pathogen Interactions
GDOA	Graphic Descriptor Ontology Anatomy Extension
PTO	Plant Trait Ontology
MELLO-D	MEdical LifeLog Ontology for people with Disability
ECOCORE	An ontology of core ecological entities
FIRE	Fire Ontology
ECM4M-MD-VOCABS	EarthCube M4M Metadata Vocabulary
DDANAT	Dictyostelium Discoideum Anatomy Ontology
PATIT	Placental Investigative Technique
EMAP	Mouse Gross Anatomy and Development Ontology
ITEMAS	Medical Technology Innovation in healthcare centers
SENSO	Sensitive Data Ontology
BOF	Biodiversity Ontology
UGANDA_DISEASES	Uganda_diseases
TAO	Teleost Anatomy Ontology
TAON	Therapeutic Antibody Ontology
SPO	Skin Physiology Ontology
OBOREL	Relations Ontology
XEO	XEML Environment Ontology
DOVES	Digital medicine Outcomes Value Set (DOVeS) Ontology
NIGO	Neural-Immune Gene Ontology
BPFORMS	Ontology of chemically concrete, composable DNA, RNA, and protein residue and crosslinks
DATACITE	SPAR DataCite Ontology
MARC-RELATORS	MARC Code List for Relators
FDC-GDMT	Ontology for Generic Dataset Metadata Template
ONTOTOX	Chemotherapy Toxicities Ontology
CTX	Cerebrotendinous Xanthomatosis Ontology
PMA	Portfolio Management Application
PPO	Plant Phenology Ontology
STO-DRAFT	The Stroke Ontology
AEO	Anatomical Entity Ontology
BTO-PROVO	Brinell Test Ontology-PROVO
UPA	Unipathway
DCT	DC Terms
CO-WHEAT	Wheat Trait Ontology 
MOP	Molecular Process Ontology
INTO	Indian Terrorism Ontology
HENECON	Head and Neck Cancer Ontology
OGDI	Ontology for Genetic Disease Investigations
ECSO	The Ecosystem Ontology
GPML	Graphical Pathway Markup Language
OLAM	Ontology of Laboratory Animal Medicine
OLAS	Ontology of Laboratory Animal Science
JSO	JS Ontology
EUPATH	VEuPathDB Ontology
PAINO	Pain Ontology
O-REXTECH	OSIRIS-REx Analytical Technique
FDSAJFAHSJK	OWL_XML_Tool5
BHN	Biologie Hors Nomenclature
BRAIN-COF	Computational Ontology Framework for Brain Profiles
PNADO	Pneumonia Diagnosis Ontology
FLOPO	Flora Phenotype Ontology
ORNASEQ	Ontology of RNA Sequencing
ONTOAD	Bilingual Ontology of Alzheimer's Disease and Related Diseases
HRDO	Disease core ontology applied to Rare Diseases
CDPEO	Chronic Disease Patient Education Ontology
PSO	PatientSafetyOntology
CARELEX	Content Archive Resource Exchange Lexicon
ELTER_CL	eLTER Controlled Lists
MATRROCKIGNEOUS	Material Rock Igneouus
BMS-LM	BioMedical Study Lifecycle Management
LIPRO	Lipid Ontology
OPDRE	OPD Regitry Ethiopia
FB-CV	FlyBase Controlled Vocabulary
CHEBI	Chemical Entities of Biological Interest Ontology
PMO-SPEED	PMO Playing Speed Vocabulary
SHEDDING-HUB	Pathogen and Biomarker Shedding
IDODEN	Dengue Fever Ontology
BIRTHONTO	BirthOnto: Birth Data Analysis
MMO	Measurement Method Ontology
IDOMAL	Malaria Ontology
MEO	Metagenome and Microbes Environmental Ontology
IDEM	IDEM: wInD Energy Models Taxonomy
DILON	Dietary lifestyle ontology
FMPM	Food Matrix for Predictive Microbiology
EDAM	EDAM - The data analysis and management ontology
IXNO	Interaction Ontology
PATCT	Placental Cell Type
GML	Ontology for Geography Markup Language (GML3.0)
HIV	HIV ontology
DSIP1V	DSIP1_vocabulary
OBCS	Ontology of Biological and Clinical Statistics
suicideo	suicideonto
SMASH	SMASH Ontology
MRO	Defen
BAO	BioAssay Ontology
GVO	Genome Variation Ontology
NIFCELL	Neuroscience Information Framework (NIF) Cell Ontology
IBD	Indian Biodiversity Ontology
ISO19115DTC	ISO 19115 Date Type Code
ONL-MR-DA	Magnetic Resonance Dataset Acquisition Ontology
MISO	Microbial Isolation Source Ontology
CTENO	Ctenophore Ontology
MSR	Mammography screening recommendation
BIPOM	Biological interlocked Process Ontology for metabolism
LOINC	Logical Observation Identifier Names and Codes
ENTITY	ISO-15926-2_2003_entityMembership
RADLEX	Radiology Lexicon
VIO	Vaccine Investigation Ontology
MCO4MCRE	Multiplex Classification Ontology for the MultiCaRe Experiment
RDL	RDL
SURGICAL	Nurse Surgical
RADXTT-MVREASONS	RADx Tiger Team Missing Value Reasons
OMCO	OligoMetastatic Cancer Ontology
BPT	Biological Pathway Taxonomy
CHO	ChemoOnto
BMT	Biomedical Topics
UPHENO	Combined Phenotype Ontology
WEAVE	WEAVE: Wind Energy ActiVitiEs
PLANA	Planarian Anatomy and Developmental Stage Ontolgoy
MNR	Material Natural Resource 
ELIG	Eligibility Feature Hierarchy
VARIO	Variation Ontology
PORO	Porifera Ontology
ASDPTO	Autism Spectrum Disorder Phenotype Ontology
SOY	Soy Ontology
CRO	Contributor Role Ontology
LEGALAPA	legalapa
DEB	Devices, Experimental scaffolds and Biomaterials Ontology
APRO	Ancient Poet Resource Ontology
ICPS	International Classification for Patient Safety
CABRO	Computer Assisted Brain Injury Rehabilitation Ontology
HELIFIT	HeLiFit-Ontology
I2SV	Integration and Implementation Sciences Vocabulary
OCHV	Ontology of Consumer Health Vocabulary
GRO-CPD	Cereal Plant Development Ontology
NIFSUBCELL	Neuroscience Information Framework (NIF) Subcellular Ontology
NMOSP	NeuroMorpho.Org species ontology
FB-DV	Drosophila Development Ontology
CHIRO	CHEBI Integrated Role Ontology
HAMIDEHSGH	Inherited Retinal Dystrophy
MIM	Molecular Interaction Map
SEPON	Sepsis Ontology
TMA	Tissue Microarray Ontology
TIMEBANK	Timebank Ontology
NERO	Named Entity Recognition Ontology 
N-CDOH	Non Clinical Determinants of Health
OCD	OCD ontology
OCDM	Ontology of Craniofacial Development and Malformation
CEDARPC	CEDAR Provisional Classes
WSM-LIBRARY	MWS
MNV	VODANA Migrants
NIST_GEL	NIST Genome Editing Lexicon
FAST-FORMGENRE	FAST (Faceted Application of Subject Terminology) FormGenre facet
CVDO	Cardiovascular Disease Ontology
SPTO	Solanaceae Phenotype Ontology
GALEN	Galen Ontology
BIOMODELS	BioModels Ontology
PREGONTO	Pregnancy Ontology
URL	URL ONTOLOGY
EXO	Exposure Ontology
EXON	Experimental Ontology
KOIO	Knowledge Object Implementation Ontology
DCAT-FDC	Data Catalog Vocabulary (DCAT)
POEM	Psychometric Ontology of Experiences and Measures
OFL	 A comprehensive ontology of flaps in reconstructive surgery
SD3	Simulation Delivery and Documentation Deviations
ONVOC	OpenNeuro Vocabulary
BT	BioTop Ontology
BE	Bioentities
BP	BioPAX Ontology of Biological Pathways
ONTOLURGENCES	Emergency care ontology
TEST_CBI	test_cbi
ADCAD	Arctic Data Center Academic Disciplines Ontology
DECIDE	DECIDE ONTOLOGY
ISO19115ROLES	ISO 19115 Role Codes
ODNAE	Ontology of Drug Neuropathy Adverse Events
PSO_2	PatientSafetyOntologyRevisted
ONTODM-ALGORITHM	OntoDM-core/algorithms
VFB_DRIVERS	vfb_drivers
LIFO	Life Ontology
PHY	physiotherapy
DERMO	Human Dermatological Disease Ontology
MSV	Metagenome Sample Vocabulary
OCRE	Ontology of Clinical Research
PW	Pathway Ontology
PP	Pipeline Patterns Ontology
PR	Protein Ontology
PO	Plant Ontology
PE	Pulmonary Embolism Ontology
PU	Test Dataset
ODAE	Ontology of Drug Adverse Events
NGSONTO	NGS ontology
NGBO	Next Generation Biobanking Ontology
DSIP7	DSIP_FieldLab_7
CRENO	Culture, Race, Ethnicity and Nationality Ontology
DDSS	Health_ontology
DPCO	Diabetes Pharmacology Ontology
APATANDT	APA Tests and Testing cluster
OBI	Ontology for Biomedical Investigations
OBIB	Ontology for Biobanking
CTO-NDD	Clinical Trials Ontology - Neurodegenerative Diseases
RB	RegenBase ontology
RS	Rat Strain Ontology
RO	Radiomics Ontology
OGMD	Ontology of Glucose Metabolism Disorder
OGMS	Ontology for General Medical Science
QUDT	Quantities, Units, Dimensions, and Types Ontology
UMMS	FirstOntologyForUMMS
TML	trasformative machine learning metadata
PEAO	Plant Experimental Assay Ontology
SOHO	Social Determinants of Health Ontology
PE-O	Pre-eclampsia Ontology
OBOE	The Extensible Observation Ontology
NEICBEER	The NeIC PaRI beer vocabulary
LIB	MWS-WSM
AMINO-ACID	Amino Acid Ontology
CMDO	Clinical MetaData Ontology
ONTODT	Ontology of Datatypes
TESTONTOLO	Test_data
HHEARVS	HHEAR Value Sets
SASAP	The State of Alaska's Salmon and People Ontology
OCCO	Occupation Ontology
ORTH	Orthology Ontology
BCTT	Behaviour Change Technique Taxonomy
GNO	Glycan Naming Ontology
HIVHPVSCHISTOSOM	HIVHPVSchistosomiasis
IOBC	Interlinking Ontology for Biological Concepts
FAST-EVENT	FAST (Faceted Application of Subject Terminology) Event
NIO	Neuropsychological Integrative Ontology
CMPO	Cellular microscopy phenotype ontology
GSSO	Gender, Sex, and Sexual Orientation Ontology
HPIO	Host Pathogen Interactions Ontology
GLYCORDF	GlycoRDF
SYRIANDRUGS	Syrian Drugs and medicines
MFMO	Mammalian Feeding Muscle Ontology
SIBO	Social Insect Behavior Ontology
ECO	Evidence and Conclusion Ontology
IPD	injury process description ontology
VIVO	VIVO Ontology for Researcher Discovery
MADS-RDF	Metadata Authority Description Schema in RDF
SIO	Semanticscience Integrated Ontology
UO	Units of Measurement Ontology
EHDAA	Human Developmental Anatomy Ontology, abstract version 1
EHDAA2	Human Developmental Anatomy Ontology, abstract version 2
SSBD	SSBD Ontology
RSA	Reference Sequence Annotation
TTO	Teleost Taxonomy Ontology
TEMPO	TempO
ICD-O-3	International Classification of Diseases for Oncology, 3rd edition
SEP	Sample Processing and Separation Techniques Ontology
DREAMDNPTO	Dementia-Related Emotional And Mood Disturbance Non-Pharmacological Treatment Ontology
NPI	Non-Pharmacological Interventions (NPIs)
BFLC	LC BIBFRAME 2.0 Vocabulary Extension
HHEAR	Human Health Exposure Analysis Resource
HHEARP	HHEAR Properties
SARSMUTONTO	Ontology for SARS-CoV-2  lineages and mutations
ECP	Electronic Care Plan
CARO	Common Anatomy Reference Ontology
BCSR-ONTO	Breast cancer screening recommendation ontology
LPT	Livestock Product Trait Ontology
SCHEMA	Schema.org core and all extension vocabularies
ORCS	Ontology for Representing CDM Semantics
GENAI	Generative AI Ontology
NBO	Neuro Behavior Ontology
PHARMGKB	PharmGKB Ontology
GDMT	Generic Dataset Metadata Template Vocabulary
BSPO	Spatial Ontology
OMRSE	Ontology for Modeling and Representation of Social Entities
BHO	Bleeding History Phenotype Ontology
CDO	Chinese Diabetes Mellitus Ontology
CDOH	Commercial determinant of Health Ontology
ADICAP	Association pour le Développement de l'Informatique en Cytologie et Anatomie Pathologique
COHSI2TERMSWEEKX	cohsi2termsweekx
MAXO	Medical Action Ontology
CAO	Clusters of Orthologous Groups (COG) Analysis Ontology
DMTO	Diabetes Mellitus Treatment Ontology
TM-MER	Traditional Medicine Meridian Value Sets
MAMO-SCR-ONTO	Mammography Screening Ontology
OMO	OBO Metadata Ontology
MHMO	Mental Health Management Ontology
UNITSONT	Units Ontology
COMET	LinkML Common Metadata Elements and Terms
BERO	Biological and Environmental Research Ontology
DRMO	Dental Restorative Material Ontology
ASSAYNODE	Assaynode
NEIC-ONTO	Unoffical NeIC Organisation Vocabulary
NIC	Nursing Interventions Classification
EFO	Experimental Factor Ontology
CONTSONTO	Continuity of care
MOMCARE	MomCareVocabulary
HINO	Human Interaction Network Ontology
PEO_ONTOLOGY	Prompt Engineering Ontology
PCL	Provisional Cell Ontology
OOSTT	Ontology of Organizational Structures of Trauma centers and Trauma systems
ISO19115SRS	ISO 19115 Reference Systems
ISO19115TCC	ISO 19115 Topic Categories
M4M-21-VARIABLES	M4M.21 FAIRWare Variables
FOODON	The FoodOn Food Ontology
PBPKO	Physiologically Based Pharmacokinetic ontology
TRAK	Taxonomy for Rehabilitation of Knee Conditions
KENYAANC	kenyaancfile
INBIODIV	An Ontology for Indian Biodiversity Knowledge Management
FMA	Foundational Model of Anatomy
CANONT	Upper-Level Cancer Ontology 
DCAT3	DCAT3
OBI_BCGO	Beta Cell Genomics Ontology
M4M-21-SUBJECTS	M4M.21 FAIRWare Subjects
HIO	Hearing Impairment Ontology
OPTION-ONTOLOGY	Optimization Algorithm Benchmarking Ontology
MFO	Medaka Fish Anatomy and Development Ontology
PDUMDV	Platynereis Developmental Stages
VRD	Vaccineresearchdata
BCS8	Breast Cancer Staging - 8th Edition
BCS7	Breast Cancer Staging - 7th Edition
VIVO-ISF	VIVO-Integrated Semantic Framework
ASPECT	ASPECT: wind energy vAriableS, ParametErs and ConsTants
BRAZI	Estados, Municipios, Bairros e Regiões do Brasil
BCI-O	Brain-Computer Interaction (BCI) Ontology
ICPC2P	International Classification of Primary Care - 2 PLUS
DSEO	Data Science Education Ontology
HO	Histological Ontology
HW	wsm
HP	Human Phenotype Ontology
HC	Habronattus Courtship Ontology
NIFDYS	Neuroscience Information Framework (NIF) Dysfunction Ontlogy
DATAHUB	RADx Data Hub Ontology
OCO	OpenCareOntology 
APAEDUCLUSTER	Educational Cluster
PROJ	Project ontology
HANCESTRO	Human Ancestry Ontology
ZAHRAHADDAD	ارتباطات
HSO	Health Surveillance Ontology
QUDT2	Quantities, Units, Dimensions and Types (QUDT) Schema - Version 2.0
GMM	GoMapMan
MY_SYRIANCINEMA	MWS-WSM Syrian Cinema Ontology
REPRODUCE-ME	REPRODUCE-ME
DCCDFV	Dublin Core Collection Description Frequency Vocabulary
PREMEDONTO	Precision Medicine Ontology
NONRCTO	Non-Randomized Controlled Trials Ontology
ONTOSIM	The Ontology of Information System on Mortality
ZONMW-CONTENT	ZonMW COVID-19
APATREATMENT	APA Treatment Cluster
MELO	Melanoma Ontology
CHEMINF	Chemical Information Ontology
NDFRT	National Drug File - Reference Terminology
GLYCOCOO	GlycoConjugate Ontology
M4M19-SUBS	M4M19 Subjects
ISSVA	International Society for the Study of Vascular Anomalies (ISSVA) Ontology
PHFUMIADO	Phallusia fumigata Anatomy and Development Ontology
LHN	Loggerhead Nesting Ontology
PATEL	Archana Patel
EVI	Evidence Graph Ontology
ONTODM-CORE	Ontology of Core Data Mining Entities
DSIP8	DSIP8REFUGEE
AGROMOP	Control de Cacao
RETO	Regulation of Transcription Ontology
SCO_F23	Syrian Cinema Ontology - ahmad - F23
MESH	Medical Subject Headings
ICEO	Integrative and Conjugative Element Ontology
ROCKNROLLTEST	ROCK-N-ROLL-TEST
HCM-D	Home Cage Monitoring definition
VBO	Vertebrate Breed Ontology
PCO	Population and Community Ontology
FITBIT	Fitbit Vocabulary
OPTIMAL	OPTImAL: An ontology for patient adherence modeling in physical activity domain
COVID-19	COVID-19 Ontology
TCDO	Traditional Chinese Drug Ontology
OOEVV	Ontology of Experimental Variables and Values
NIFSTD	Neuroscience Information Framework (NIF) Standard Ontology
AI-RHEUM	Artificial Intelligence Rheumatology Consultant System Ontology
AMPHX	The Amphioxus Development and Anatomy Ontology
IDO-COVID-19	The COVID-19 Infectious Disease Ontology
ONTRISCAL	Ontology of Risk Stratification in Mental Health
DIAB	BioMedBridges Diabetes Ontology
DFO	Databank Family Ontology
BRCT	Brain Region & Cell Type terminology
CTGO	Clinical Trials Gov Ontology
BMONT	The Biomarker Ontology
GENDER	Gender Identity
ACESO	Adverse Childhood Experiences Ontology
CRYOEM	Cryo Electron Microscopy
HIVMT	HIVMutation
ETHANC	ETHANC
PROVO	Provenance Ontology
DSIPFL7	DSIP_Fieldlab_7
ICD10CM	International Classification of Diseases, Version 10 - Clinical Modification
NANDO	Nanbyo Disease Ontology
PLOSTHES	PLOS Thesaurus
GEO	Geographical Entity Ontology
GO-PLUS	go-plus
WEAR	WEAR: Wind Energy mAteRials Taxonomy
DATACITE-VOCAB	DATACITE V4.4
VODANA-MIGRANTS	VODANA MIGRANTS VOCABULARY
MINERAL	Material Mineral
CIO	Confidence Information Ontology
CKDO	Chronic Kidney Disease Ontology
HDMPONTO	HierarchicalDMProcessOnto
ONSTR	Ontology for Newborn Screening Follow-up and Translational Research
HCODONONT	HGeneCodonOntology
VODANACOVID	VODANA-COVIDTERMS
TEST_A	TEST_A
MIRAPIE	MInimal Requirements for Automated Provenance Information Enrichment in biomedical research
PCALION	Prostate Cancer Lifestyle Ontology
HCPCS	Healthcare Common Procedure Coding System
MONO	Monogenean Ontology
MACROALGAETRAITS	Macroalgae Traits Thesaurus
MOSAIC	The MOSAiC Ontology
BCTEO	Bone and Cartilage Tissue Engineering Ontology
PEO	Parasite Experiment Ontology
TRIAGE	Nurse triage
OBIWS	Bioinformatics Web Service Ontology
PHIPO	Pathogen Host Interaction Phenotype Ontology
SOCPRES	Social Prescribing Ontology
MCR_TX	MultiCaRe Taxonomy
SP_ONTOLOGY	SmartPITeS Proyect Ontology for Complex Chronic Patients
ONTOPARON_SOCIAL	Ontology of amyotrophic  lateral sclerosis, social module
MCRO	Model Card Report Ontology
SITBAC	Situation-Based Access Control Ontology
PAE	Plant Anatomy
NDDO	Neurodegenerative Disease Data Ontology
NDDF	National Drug Data File
OPD-NAMBOBI	SELECTED OTHER PRIORITY DISEASES UNDER IDSR (INTEGRATED DISEASE SURVEILLANCE AND RESPONSES)
SCDO	Sickle Cell Disease Ontology
LBO	Livestock Breed Ontology
LUNGMAP-MOUSE	Anatomic Ontology for Mouse Lung Maturation
SCO	Study Cohort Ontology
BDO	Bone Dysplasia Ontology
CANCO	Cancer Chemoprevention Ontology
INCENTIVE	INCENTIVE Community Controlled Vocabulary
ONTOPSYCHIA	OntoPsychia, social module
ML_MCR_TX	MultiCaRe Taxonomy (ML Labels)
DINTO	The Drug-Drug Interactions Ontology
NIHSS	National Institutes of Health Stroke Scale Ontology
OPL	Ontology for Parasite LifeCycle
APO	Ascomycete Phenotype Ontology
MPATH	Mouse Pathology Ontology
MMUSDV	Mouse Developmental Stages
VTO	Vertebrate Taxonomy Ontology
ROS	Radiation Oncology Structures Ontology
ALLERGYDETECTOR	Allergy Detector II
MHCRO	MHC Restriction Ontology
GENO	Genotype Ontology
DCO	Dispedia Core Ontology
NHSQI2009	NHS Quality Indicators
HORD	Holistic Ontology of Rare Diseases
HASCO	Human-Aware Science Ontology
MIAPA	MIAPA Ontology
ENVTHES	Thesaurus for long-term ecological research, monitoring, experiments
GEOSPARQL	GeoSPARQL
MVAONT	Mosquito Vector Association Ontology with Biocontrol Agents
ROLEO	Role Ontology
LEGALAPATEST2	apalegal
PICO	Pathogen-related Informed Consent Ontology
MODSCI	Modern Science Ontology
OVAE	Ontology of Vaccine Adverse Events
AGROCYMAC	Control y Monitoreo de afecciones en los cultivos
GECCO	COVID-19 Common Datamodel
LSFC	LSFC
LSFO	Lifestyle Factor Ontology
HMISLAB0115	HMIS LAB 011 5
PINO	Pregnancy Information Needs Ontology
FOBI	FOBI (Food-Biomarker Ontology)
MIO	Myocardial Infarction Ontology
HSCLO38	Homo sapiens Chromosomal Location Ontology for GRCh38
LCGFT	Library of Congress Genre/Form Thesaurus for Library and Archival Materials
NOMEN	NOMEN - A nomenclatural ontology for biological names
INFRA-EN	Infrastructure
LEPAO	Lepidoptera Anatomy Ontology
KORO	Knowledge Object Reference Ontology
EO	Ethnicity Ontoloy
EP	Cardiac Electrophysiology Ontology
EOL	Environment Ontology for Livestock
BSAO	Botryllus schlosseri anatomy and development ontology
GAZ	Gazetteer
HUPSON	Human Physiology Simulation Ontology
FARMACI	FARMACI AIFA
TP4	Oualid
AI	Artificial Intelligence
AO	Asthma Ontology
XLMOD	mass spectrometry cross-linking and derivatization reagents
SSE	Surgical Secondary Events
PGHD-BP	PGHD Auxillary - BP
EVS	Exposure Value Set
INTVEETYPE	Interviewee Type
HCDR	Homelessness and Clinical Data Recording
EMAPA	Mouse gross anatomy and development, timed
INVERSEROLES	ISO-15926-2_2003_inverseRoles
PREO	Presence Ontology
ICDO	International Classification of Diseases Ontology
FALDO	Feature Annotation Location Description Ontology 
I-ADOPT	I-ADOPT Framework Ontology
HTN	Hypertension Ontology
COID	Combined Ontology for Inflammatory Diseases
CHMO	Chemical Methods Ontology
MLTX	Machine Learning Methodology Taxonomy Mapping
IDO	Infectious Disease Ontology
pseudo	Pseudogene
CATALOG-THEMES	Catalog Themes
APOLLO-SV	Apollo Structured Vocabulary
DERMLEX	Dermatology Lexicon
IBO	Imaging Biomarker Ontology
PHENX	PhenX Phenotypic Terms
AGRO	AGRonomy Ontology
SMO	Syrian Movies Ontology
APASTATISTICAL	APA Statistical Cluster
DCM	DICOM Controlled Terminology
ECAO	The Echinoderm Anatomy and Development Ontology
PARTUMDO	postpartum depression ontology
GRO	Gene Regulation Ontology
MATRROCK	Material Rock
STRONG	Mental Stress Ontology
ADHER_INTCARE_EN	Adherence and Integrated Care
ONTOPNEUMO	Ontology of Pneumology
MIRO	Mosquito Insecticide Resistance
MHC	Major Histocompatibility Complex Ontology
SCO_V1	Sustainability Core Ontology
ONTOPARON	Ontology of Amyotrophic Lateral Sclerosis, all modules
ICD10	International Classification of Diseases, Version 10
SAO	Subcellular Anatomy Ontology
FLDLB3	FIELDLAB3_2023_2
TRON	Tribolium Ontology
KUSIIMA	naava
JERM	Just Enough Results Model Ontology
NLN	NLighten Ontology
OCE	Ontology of Chemical Elements
CHEAR	Children's Health Exposure Analysis Resource
BAO-GPCR	G Protein-Coupled Receptor BioAssays Ontology
CPTAC	CPTAC Proteomics Pipeline Infrastructure Ontology
ORDO	Orphanet Rare Disease Ontology
COPPER	COntextualised and Personalised Physical activity and Exercise Recommendations
PACO	Physical Activity Ontology
HEIO	Regional Healthcare System Interoperability and Information Exchange Measurement Ontology
ABD	Anthology of Biosurveillance Diseases
AFPO	African Population Ontology
FIX	Physico-Chemical Methods and Properties
PAV	PAV Provenance, Authoring and Versioning
NCCNEHR	NCCN EHR Oncology Categories
MSTDE	Minimal Standard Terminology of Digestive Endoscopy
M4M-20-SUBJECTS	M4M.20 FAIRWare Subjects
LUNGMAP_H_CELL	Cell Ontology for Human Lung Maturation
PDON	Parkinson's Disease Ontology
PDO	Pathogenic Disease Ontology
ISO639-1	ISO 639-1: Codes for the Representation of Names of Languages - Part 1: Two-letter codes for languages
ISO639-2	ISO 639-2: Codes for the Representation of Names of Languages
PECO	Plant Experimental Conditions Ontology
FBbi	Biological Imaging Methods Ontology
TCO	Thyroid Cancer Ontology
DISDRIV	Disease Drivers Ontology
TST7	FIELDLAB3_2023
VEO	Visualized Emotion Ontology
GENEPIO	Genomic Epidemiology Application Ontology 
LUNGMAP_M_CELL	Cell Ontology for Mouse Lung Maturation
BFO	Basic Formal Ontology
OGI	Ontology for Genetic Interval
RBO	Radiation Biology Ontology
IDQA	Image and Data Quality Assessment Ontology
ELD	EthiopianListOfDiseases
ICECI	International Classification of  External Causes of Injuries
ABA-AMB	Allen Brain Atlas (ABA) Adult Mouse Brain Ontology
ISO19115CON	ISO 19115 Constraints Information
PATO	Phenotypic Quality Ontology
ID-AMR	Infectious Diseases and Antimicrobial Resistance
PATMHC	Placental Maternal Health Conditions
NEUROBRG	NeuroBridge Ontology
OHMI	Ontology of Host-Microbe Interactions
ONTOTOXNUC	Ontology of Nuclear Toxicity
REGN_BRO	REGN_BRO
BRIDG	Biomedical Research Integrated Domain Group Model
CTO	Clinical Trials Ontology
IMGT-ONTOLOGY	Immunogenetics Ontology
M4M19-VARS	M4M19 Variables
BTO	BRENDA Tissue and Enzyme Source Ontology
SNPO	Single-Nucleotide Polymorphism (SNP) Ontology
FNS-H	FNS-Harmony
PROCO	Process Chemistry Ontology
NCCO	Nursing Care Coordination Ontology
AD-DROP	Alzheimer Disease Relevance Ontology by Process
MCHVODANATERMS	MCHVODANATERMS
EDDA_PT	EDDA Publication Types Taxonomy
MDM	Mapping of Drug Names and MeSH 2022
BCGO	Breast Cancer Grading Ontology
SVU_MWS_WSM	Syrian Cinema Ontology
ADALAB-META	AdaLab-meta ontology
EXACT	An ontology for experimental actions
ARO	Antibiotic Resistance Ontology
RVO	Research Variable Ontology
LIBRARY	wsm24
LC-CARRIERS	Library of Congress Carriers Scheme
ISO19115CC	ISO 19115 Common Classes
ISO19115CI	ISO 19115 Citation Information
GEXO	Gene Expression Ontology
STMSO	symptomatic treatment of multiple sclerosis ontology
DDIEM	Drug Database for Inborn Errors of Metabolism (DDIEM) Ontology
ADAR	Autism DSM-ADI-R ontology
LION	LipidOntology
VHOG	Vertebrate Homologous Organ Group Ontology
IDOBRU	Brucellosis Ontology
OBA	Ontology of Biological Attributes
COVID19	COVID-19 Surveillance Ontology
MPIO	Minimum PDDI Information Ontology
PHYLONT	Phylogenetic Ontology
FAST-EVENT-SKOS	FAST (Faceted Application of Subject Terminology) Event Facet
ISO19108TO	ISO 19108 Temporal Objects
SOCMEDIA	Sercan Kiyak
GRO-CPGA	Cereal Plant Gross Anatomy Ontology
AERO	Adverse Event Reporting Ontology
LONGCOVID	Long Covid Phenotype Ontology
AHOL	Animal Health Ontology for Livestock
CYTO	CYTOKINE
MIRNAO	MicroRNA Ontology
AIO	Artificial Intelligence Ontology
RADMO	RADx Metadata Ontology
VDOT	Viral Disease Ontology Trunk
MIDO	Medical Imaging and Diagnostic Ontology
HP_O	Hypersensitivity pneumonitis ontology
PESONT	Preposition_enabled Spatial Ontology
ZP	Zebrafish Phenotype Ontology
PHENOMEBLAST	PhenomeBLAST Ontology
THREE-ST	3-Step Theory of suicide
CODO	CODO: an Ontology for collection and analysis of COviD-19 data
HSPO	Health and Social Person-centric Ontology
DOCCC	Diagnosis Ontology of Clinical Care Classification
VODANA-GENERAL	VODANATERMS
OPDRONT	OPD Register Ontology
PTRANS	Pathogen Transmission Ontology
ONTOMA	Ontology of Alternative Medicine, French
MEDICALINFO	mymedicalinformation
HECON	HECON: Health Condition Evolution Ontology
NMR	NMR-Controlled Vocabulary
BTO-BFO	Brinell Test Ontology-BFO
PEDTERM	Pediatric Terminology
VODANETHIOPIA_OR	ETHIOPIA_OUTPATIENT
KGCL	Knowledge Graph Change Language
BIFO	Biofilm Ontology
OTO	 Obesity Tracking Ontology
MIFD	Minimum Information for Fermentation Devices
MIFE	Minimum information for fermentation experiments
EVORAO	European Viral Outbreak Response Alliance Ontology
IRD	Inherited Retinal Dystrophies
IRDG	Data harmonization ontology for cross border malaria surveillance 
SST	SATUSEHAT Thesis
ONTONEO	Obstetric and Neonatal Ontology
SNMI	Systematized Nomenclature of Medicine, International Version
ESSO	Epilepsy Syndrome Seizure Ontology
EHDA	Human Developmental Anatomy Ontology, timed version
ECDO	Elderly Care Dementia Ontology
BRSO	Biological Resource Schema Ontology
UBERON	Uber Anatomy Ontology
HAAURAADO	Halocynthia aurantium Anatomy and Development Ontology
MFOEM	Emotion Ontology
FB-SP	Fly Taxonomy
ONL-TASKS	Cognitive Reserves Assessment Tasks
MERA	Medical Educational Resource Aggregator
ONTOAVIDA	OntoAvida: ontology for Avida digital evolution platform
FIDEO	Food Interactions with Drugs Evidence Ontology
INBANCIDO	Assessment of Indian Economy During Covid-19 
ETANC	ETHIOPIANC
TARA	TARA Acupoints Ontology
MDDB	Master Drug Data Base Clinical Drugs
BNO	Bionutrition Ontology
STATO	Statistics Ontology
CWD	Consumer Wearable Device
REX	Physico-Chemical Process
REXO	Regulation of Gene Expression Ontolology
FYPO	Fission Yeast Phenotype Ontology
DOREMUS-KEYS	Doremus List of Keys
PATHLEX	Anatomic Pathology Lexicon
BCO	Biological Collections Ontology
BCON	Breast Cancer Ontology
TAXRANK	Taxonomic Rank Vocabulary
VICO	Vaccination Informed Consent Ontology
BT-ONTOLOGY	BrainTeaser Ontology (BTO)
ISO-ANNOTATIONS	ISO-15926-2_2003_annotations
EPILONT	Epilepsy Ontology
FDT-O	FAIR Data Train Ontology
HERO	Healthcare Monitoring and Emergency Response Ontology
HOM	Ontology of Homology and Related Concepts in Biology
HOME	Health Ontology for Minority Equity
REPO	Reproductive Trait and Phenotype Ontology
CIINTEADO	Ciona intestinalis Anatomy and Development Ontology
PROCCHEMICAL	Chemical Process
ISO-15926-2_2003	ISO-15926-2_2003_oil
BCMO	Breast Cancer-Microbiome Ontology 
CCO	Cell Cycle Ontology
CCON	Cerrado concepts and plant community dynamics
GO-EXT	Gene Ontology Extension
HAO	Hymenoptera Anatomy Ontology
LDA	Ontology of Language Disorder in Autism
SK	Digital Forensic
SP	SMART Protocols
SO	Sequence Types and Features Ontology
METPO	METPO
INCENTIVE-VARS	INCENTIVE Variables
WSIO	Web-Service Interaction Ontology
SOIL-PROF	Soil Profile classifiers
GFO-BIO	General Formal Ontology for Biology
CARRE	CARRE Risk Factor ontology
SHR	Student Health Record Ontology
VT	Vertebrate Trait Ontology
VO	Vaccine Ontology
RDFS	The RDF Schema vocabulary
LANDFORM	Landform classifiers
OPDZIMBABWE	OPDZimbabwe
OntoVIP	Medical image simulation
LUNGMAP-HUMAN	Anatomic Ontology for Human Lung Maturation
PAYOR	Payor
DSIPF7	DSIP FiledLab7 
ONLIRA	Ontology of Liver for Radiology
BKO	Bricks ontology
MEDO	Mouse Experimental Design Ontology
SDOED	Social Determinants of Education Ontology
EPISEM	Epilepsy Semiology
SEDI	Semantic DICOM Ontology
DCMITYPE	DCMI Type Vocabulary
YUNPING	yunping
GMO	Growth Medium Ontology
ZONMW-ADMIN-MD	ZonMW Administrative Metadata Vocabulary
MOC	Material Organic Compound
PROPREO	Proteomics Data and Process Provenance Ontology
OCVDAE	Ontology of Cardiovascular Drug Adverse Events
NEMO	Neural ElectroMagnetic Ontology
IAO	Information Artifact Ontology
ICO	Informed Consent Ontology
NEET_	NEET_Ontology_
FB-BT	Drosophila Gross Anatomy Ontology
M4M-20-VARIABLES	M4M.20 FAIRWare Variables
REPOS	repository
HRAVS	HuBMAP Research Attributes Value Set
CASE-BASE-ONTO	Case-base ontology for gastric dystemperament in Persian medicine
ONL-MSA	Mental State Assessment
XREF-FUNDER-REG	CrossRef Funder Registry
DIKB	Drug Interaction Knowledge Base Ontology
HSAPDV	Human Developmental Stages Ontology
EBP	EmpowerBP
MFOMD	MFO Mental Disease Ontology
OHD	The Oral Health and Disease Ontology
EPO	Early Pregnancy Ontology
ZFS	Zebrafish Developmental Stages
GFO	General Formal Ontology
SLEEP	SLEEP ontology
HENEGEO	Head and Neck Cancer - Clinical and Gene Ontology
UHC-METADATA	UHC Metadata
FENICS	Functional Electrophysiology Nomenclature for Ion Channels
VODANA-MI	VODANA-MIGRANTS-INTERVIEWS
ECTO	Environmental conditions, treatments and exposures ontology
MAMO	Mathematical Modelling Ontology
CRISP	Computer Retrieval of Information on Scientific Projects Thesaurus
DUO	The Data Use Ontology
DMDSONT	Diabetes Mellitus Diagnosis and Support Ontology 
CHR	Monochrom
CHRO	Chromatin Regulator Ontology
COMO	Context and Measurement Ontology
MCO4HKE	Multiplex Classification Ontology for the HyperKvasir Experiment
COPDO	COPD Ontology
XCO	Experimental Conditions Ontology
COGAT	Cognitive Atlas Ontology
HIVO004	HIVOntologymain.owl
MCO	Microbial Conditions Ontology
PBO	Plant Breeding Ontology
HGNC	HUGO Gene Nomenclature
PDRO	The Prescription of Drugs Ontology
NPO	NanoParticle Ontology
CCONT	Cell Culture Ontology
VODAN_ANC	VODAN ANC Vocabulary 
ENVO	Environment Ontology
G-PROV	Guideline Provenance
BTO_ONTOLOGY	Brain Tumour Ontology
MCCL	Cell Line Ontology [by Mahadevan]
MCCV	Microbial Culture Collection Vocabulary
BLLM	Large Language Model Ontology
DRPSNPTO	Dementia-Related Psychotic Symptoms Non-Pharmacological Treatment Ontology
GOLDTERMS	GOLD Ecosystem Classification
PIERO	Enzyme Reaction Ontology for annotating Partial Information of chemical transformation
FCC1	Fernald Community Cohort N
FO	Fern Ontology
FG	FAIR Genomes
CU-VO	Venom Ontology
SATO	SATO (IDEAS expAnded wiTh BCIO): workflow for designers of patient-centered mobile health behaviour change intervention applications
OREX-SAM	OSIRIS-REx sample type
WHO-ART	World Health Organization (WHO) Adverse Reaction Terminology
WB-LS	C. elegans Development Vocabulary
SCIO	Spinal Cord Injury Ontology
ADMF	alzhaimer dessiese main factors
ADMO	Alzheimer Disease Map Ontology
RNRMU	RNRMU
EDEM-CONNECTONTO	eDEM-Connect: Ontology of Dementia-related Agitation and Relationship between Informal Caregivers and Persons with Dementia
CO	Crop Ontology
CS	Coping Strategies for Adverse Drug Events Ontology
CN	computer network
CL	Cell Ontology
GFF-M4M	GO FAIR M4M
PDQ	Physician Data Query
CDNO	Compositional Dietary Nutrition Ontology
PDO_CAS	Plant Diversity Ontology
ZEA	Maize Gross Anatomy Ontology
EMO	Enzyme Mechanism Ontology
CDAO	Comparative Data Analysis Ontology
TXPO	Toxic Process Ontology
QUDT2-1	Quantities, Units, Dimensions and Types (QUDT Version 2.1)
ACGT-MO	Cancer Research and Management ACGT Master Ontology
KISAO	Kinetic Simulation Algorithm Ontology
RPO	Resource of Asian Primary Immunodeficiency Diseases (RAPID) Phenotype Ontology
SYRIAN-CINEMA	Syrian Cinema
PTS	Pathway Terminology System
EXMO	Exercise Medicine Ontology
MEDLINEPLUS	MedlinePlus Health Topics
LICO	Liver Case Ontology (LiCO)
MAT	Minimal Anatomical Terminology
MATR	Material
MINI-FAST-1	mini fast test
NEUMORE	Neural Motor Recovery Ontology
FAO	Fungal Gross Anatomy Ontology
PANET	PaN Experimental technique
ENVS_VARIABLES	ENVS variables
SNOMEDCT	SNOMED CT
HTO	Horridge Test Ontology
FIT_BIT	Fitbit Vocabularies 
ICW	International Classification of Wellness
OGCO	OriGinal Chemical Ontology
OCIMIDO	Ocular Immune-Mediated Inflammatory Diseases Ontology
INSNAME	VODANAINSNAMES
ONTOREPLICOV	OntoRepliCov
NIDM-RESULTS	NIDM-Results
HIVCRS	HIVCompoundRels
DLORO	Dependency Layered Ontology for Radiation Oncology
GFFO	Genetic Feature Format Ontology
SPD	Spider Anatomy Ontology
NRO	NeuralReprogrammingOntology
RH-MESH	Robert Hoehndorf Version of MeSH
OBOE-SBC	Santa Barbara Coastal Observation Ontology
XPO	Xenopus Phenotype Ontology
ICD9CM	International Classification of Diseases, Version 9 - Clinical Modification
INTVMODE	Interview Mode
COHSI2STUDY	cohsi2study
FAST-CHRONO	FAST (Faceted Access of Subject Terminology) Chronological Facet
IBIO	IndianBiodiversity
ADHER_INTCARE_SP	Adherence and Integrated Care in Spanish
EDDA	EDDA Study Designs Taxonomy
CPT	CPT - Current Procedural Terminology
PATGV	Placental Genetic Variance
ENM	eNanoMapper
DDPHENO	Dictyostelium Discoideum Phenotype Ontology
ESO_C	Epilepsy Semiology Ontology
BRO	Biomedical Resource Ontology
HNS	HNS_Ontolgoy
MIXS	Minimal Information about any Sequence Ontology
ATC	Anatomical Therapeutic Chemical Classification
MOOCCUADO	Molgula occulta Anatomy and Development Ontology
FISH-AST	FISH Archaeological Sciences Thesaurus
MPO	Microbial Phenotype Ontology
CSEO	Cigarette Smoke Exposure Ontology
BP-METADATA	BioPortal Metadata Ontology
CLAO	Collembola Anatomy Ontology
OBS	OntoBioStat
ITO	Intelligence Task Ontology
HPO	Hypertension-Ontology
GEOSPECIES	GeoSpecies Ontology
LEO	Living Environment Ontology
TGMA	Mosquito Gross Anatomy Ontology
ICD10PCS	International Classification of Diseases, Version 10 - Procedure Coding System
ADALAB	AdaLab ontology
OGG-MM	Ontology of Genes and Genomes - Mouse
MEPO	Mapping of Epilepsy Ontologies
ARCRC	Arctic Report Card
ONS	Ontology for Nutritional Studies
CSSO	Clinical Signs and Symptoms Ontology
APADISORDERS	Disorders cluster
UCVA	Unwarranted Clinical Variation Analysis With Contextual Factors
SWEET	Semantic Web for Earth and Environment Technology Ontology
EO1	Example Ontology
VIDO	Virus Infectious Disease Ontology
SATUSEHATTHESIS	SatuSehatThesis
MWLA	Medical Web Lifestyle Aggregator
FGNHNS	FoodGroupNHNS
M	May
MM	mm
MF	Mental Functioning Ontology
MI	Molecular Interactions
MA	Mouse Adult Gross Anatomy Ontology
MP	Mammalian Phenotype Ontology
MS	Mass Spectrometry Ontology
MO	Microarray and Gene Expression Data Ontology
PMO	Performed Music Ontology
ONE	Ontology for Nutritional Epidemiology
BIOLINK	Biolink Model
FTC	Functional Therapeutic Chemical Classification System
IFAR	Fanconi Anemia Ontology
ONL-DP	Dataset processing
CPRO	Computer-Based Patient Record Ontology
ALTPROTON	An Ontology for integration and interoperability of multi-aspect data of Protein food production chains
INBIO	Invasion Biology Ontology
IK	Irabi kassim
WB-BT	C. elegans Gross Anatomy Vocabulary
VODANAUGANDA	VODANAUGANDA
PCAO	Prostate Cancer Ontology
TEDDY	Terminology for the Description of Dynamics
GO	Gene Ontology
GB	GlycanBind
FLU	Influenza Ontology
FALL	MyOntoServiceFull_FallDetection
DIDEO	Drug Interaction and Evidence Ontology
HED	Hierarchical Event Descriptors
HL7	Health Level Seven Reference Implementation Model, Version 3
REGN_GO	REGN_GO
BCLION	Breast Cancer Lifestyle Ontology
NCIT	National Cancer Institute Thesaurus
SIMM	In Silico Methodologies Ontology for MAATrica metric
TDWGSPEC	TDWG Specimen LSID Ontology
MATRCOMPOUND	Material Compound
FAST-TITLE	FAST (Faceted Application of Subject Terminology) Title Facet
DRANPTO	Dementia-Related Agitation Non-Pharmacological Treatment Ontology
PHAGE	Phylogenetics Ontology
FAST-GENREFORM	FAST (Faceted Access of Subject Terminology) GenreForm
PHMAMMADO	Phallusia mammillata Anatomy and Development Ontology
EMIF-AD	EMIF-AD ontology
NEIO	Neural Electronic Interface Ontology
HGNC-NR	HGNC New Releases Ontology
BIBFRAME	BIBFRAME 2.0
DDI	Ontology for Drug Discovery Investigations
METABUS	metaBUS controlled vocabulary for organizational and applied psychology research
HIVHPVFGS	HIV, HPV, FGS vocabulary
SEPIO	Scientific Evidence and Provenance Information Ontology
BIBLIOTEK-O	The Biblioteko Ontology
PCMO	Pediatric Consultation and Monitoring Ontology 
PGHD_CONNECT	PGHD_CONNECT
CTU_BEREADY_GEM	CTU Bern BEReady Gemeinden
EGO	Epigenome Ontology
PPLC	Placental Pathology Lesion Classification
EDAM-BIOIMAGING	EDAM Bioimaging Ontology
MARC-LANGUAGES	MARC List for Languages
PVONTO	Pharmacovigilance Ontology
OCMR	Ontology of Chinese Medicine for Rheumatism
APACOMPUTER	Computer Cluster
PMAPP-PMO	PMO Precision Medicine Ontology
DC	Dublin Core
IAML-MOP	IAML Medium of Performance Vocabulary
T4FS	terms4FAIRskills
ATO	Amphibian Taxonomy Ontology
ATOM	Atlas Ontology Model
ATOL	Animal Trait Ontology for Livestock
M4M-CHAR	M4M-CHAR
VODANAKENYA	VODANA KENYA
NLMVS	NIH NLM Value Sets
RDA-CONTENT	RDA Content type
ICHOM-PROMS-PCB	ICHOM Set Pregnancy and Childbirth
BDPM	Base de Données Publique des Médicaments
OPB	Ontology of Physics for Biology
ISO19115	ISO 19115
ISO19110	ISO 19110 Methodology for Feature Cataloguing
CBO	Cell Behavior Ontology
DPO	Drosophila Phenotype Ontology
COB	Core Ontology for Biology and Biomedicine
MEGO	Mobile Genetic Element Ontology
OARCS	Ontology of Arthropod Circulatory Systems
FALLS	falls prevention 
ZFA	Zebrafish Anatomy and Development Ontology
C19M	COVID-19
PATAXO	Technical Taxonomies for Patents
GBM	Glioblastoma
TOK	Terminological and Ontological Knowledge Resources Ontology
SALMO	Salmonella Serotype vocabulary
SALMON	Salmon Ontology
BIPON	Bacterial interlocked Process ONtology
ILLNESSINJURY	Illness and Injury
MATRELEMENT	Material Element
INO	Interaction Network Ontology
CONDOR	Liver Cancer Ontology Diagnosis Treatment
GENE-CDS	Genomic Clinical Decision Support Ontology
DIAGONT	Diagnostic Ontology
KTAO	Kidney Tissue Atlas Ontology
FHHO	Family Health History Ontology
ISPO	Integrated Ontology for Symptom Phenotype Terminologies
RXNO	Name Reaction Ontology
BTO-EMMO	Brinell Test Ontology-EMMO
MONDO	Mondo Disease Ontology
OMIM	Online Mendelian Inheritance in Man
OMIT	Ontology for MicroRNA Target
TRANS	Nurse Transitional
ISO19115DI	ISO 19115 Distribution Information
CLYH	Clytia hemisphaerica Development and Anatomy Ontology
CTONT	Epoch Clinical Trial Ontology
TEO	Time Event Ontology
MGBD	MGB Drug List
CVAO	STO
RCTONT	Randomized Controlled Trials Ontology
DOID	Human Disease Ontology
BIOMO	Biological Observation Matrix Ontology
SSO	Syndromic Surveillance Ontology
SDO	Sleep Domain Ontology
SDOHO	social determinants of health ontology-TaoLab
GCBO	Global Code Book Ontology
HOIP	Homeostasis imbalance process ontology
CEDARVS	CEDAR Value Sets
OPE	Ontology of Physical Exercises
OGG	Ontology of Genes and Genomes
RNAO	RNA Ontology
MOOCCIADO	Molgula occidentalis Anatomy and Development Ontology
OBI_IEE	The Ontology for Biomedical Investigation based Inner Ear Electrophysiology 
NEO	Neurologic Examination Ontology
VSO	Vital Sign Ontology
APANEUROCLUSTER	APA Neuro Cluster
MATERIALSMINE	MaterialsMine Ontology
DCTERMS	DCMI Metadata Terms: properties in /terms/ namespace
ISO-FOOD	A formal representation of the knowledge within the domain of Isotopes for Food Science
DCAT	Data Catalog Vocabulary
DSIP_FL_7	DSIP_FL_7
MOOCULADO	Molgula oculata Anatomy and Development Ontology
OREX-WG	OSIRIS-REx sample analysis workgroups
NMOBR	NeuroMorpho.Org brain region ontologies
FOVT	FuTRES Ontology of Vertebrate Traits
PAYMENTMODE	Payment Mode
THESISDEMO	thesisdemo
PSIMOD	Protein Modification Ontology
CHEMROF	CHEMROF
DRON	The Drug Ontology
OFSMR	Open Predictive Microbiology Ontology
FOUR-M_VOCABS	AGE-FRIENDLY 4M VOCABULARY
CMO	Clinical Measurement Ontology
ACVD_ONTOLOGY	Atherosclerotic Cerebrovascular Disease Ontology
FASTO	HL7 FHIR and SSN ontology based Type 1 Diabetes Mellitus Ontology
SVU_MWS_WSM_F23	MWS-WSM-F23 Syrian Cinema Ontology
MIXSCV	Minimal Information about any Sequence (MIxS) Controlled Vocabularies
HOOM	HPO - ORDO Ontological Module
AFO	Allotrope Merged Ontology Suite
TEPHRAM4MEXAMPLE	Tephra M4M Example
ETHOPD	Ethiopian OPD
BIN	Body in Numbers project terminology
INSECTH	insectH
INFECTION_TRANS	Infection Transmission Ontology
HIVHPV	HIVHPV
ENDOH	Environmental Determinants of Health
BIODIVTHES	Biodiversity Thesaurus
D3O	DSMZ Digital Diversity Ontology
NXDX	Test NXDX
WETAXTOPICS	NEAT: wiNd Energy tAxonomy of Topics
RXNORM	RxNORM
WWECA	Women with Epilepsy of Child-bearing Age Ontology
VSAO	Vertebrate Skeletal Anatomy Ontology
